0000000888000000000000000000000000000000
0222222222222222202222262022222222222720
8222222222222222202208880022222222555228
8222222222222222222222222222222222222228
8222222222222222222222222222222222222728
0222222222222222033339993333333333999338
0222222222222222032222622322722222222220
0000000002200000032222222222222222555620
0333333332233333332222222322222222222220
0322222222222222232222222333333333333330
0322222222222222232222255552223222222220
0322222222222222233333333333223333333220
0322222222222222222222222222222222222220
0322222222222222233333333333223333333220
0322222222222222230222222220220222222220
0322222222222222330227222220220000000000
0333333333223333300222222220222272222220
0222222220220222222222222220220222222220
0222222220220226222222222222220222022220
0222222220220000002222222222220222026220
0222222222222222202222200222222222022220
0222222222222222282222200222222222022220
0222222222222222282222222222222222026220
0222222222222222282225552222255522022220
0222222222222222282222222222222222222220
0222222222222222282222222222222222222220
0220022225552222282222222222222222022220
0220022222222222282222222555222222027220
0262222222222222202222222222222222022220
0000000022200000002222222222222222000000
0222222222222222202222222222222222222220
0255522222222222202272222222226220000000
0222222222222222202222222222222220394930
0222222222222222200088888800000000322230
0225555222222525222222227220333333322230
0222222222222252222222222220325552222230
0222222222222525222222222222222225552230
0222555222222252222222222220322222222230
0222222222222525222222227220379999999730
0000088888800000000888800000000000000000
