0000000000000000000088888888888800000000
0227222222222723222222222222222222223620
0222222222222223222555522222222255523220
0222222222222223222222222222222222223220
0222222222222223222222222255522222222220
0222222222222223222222222222222222223330
0222222222222223222222222222222255523220
0222222222222223225552222222222222223220
0222222222222223339999932233333339933220
0222222222222222222222222222222222222220
0222222222222222222255522222222222555220
0222222222222220222222222222222222222220
0222222222222220222222222222222222222220
0000000000000000222222222222222222222220
0222222222222720222222222222222222222220
0220000022255520222222222222222222222220
0522527022222220222255552222222225555220
0225222022222222222222222222222222222220
0222222022255222222222222222222222222220
0000022000000000000888800000088880002220
0226222222722220000800033333339933330220
0252222222222520222222222252222262230220
0222522222225220222522222222222225230220
0222222222222220222222203252225222290220
0252222225222228222227203252222222230220
0222222222252228222522220326222257230220
0222522222222528222522220333339933330220
0252222222522220222222222000000000000220
0222222222222220222252222222222252222220
0225222225222220222222222222522222222220
0222222222222220000008888000000002200000
0222522222225220272222222620222222222220
0222222222222220222225222220225222222220
0222222222222220222222222228222222222220
0222208008022220822222222220222222222220
0222222222222220122222222222222222222220
0222225727522220822222222220222222222220
0222222222222220222225222228222222225220
0222222222222220222222222220222272222220
0000000000000000000000000000000000000000
