000000000000000000000000000000000000000000000000000000000000
022222222222222222222222222222222222222222222222222222222220
022222222222222222222222222222222222222222222222222222222220
022222222222222222222222222222222222222222222222222222222220
022200000002222222222222222222222222222222222222222222222220
022200000002222222222222222222222222222222222222222222222220
022200000002222222222222222222222222222222222222222222222220
022200000002222222222222222222222222222222222222222222222220
022222222222222222222222222222222222222222222222222222222220
022222222222222222222222222222222222222222222222222222222220
022222222222222222222222222222222222222222222222222222222220
022222222222222222222222222222222222222222222222222222222220
022222222222222222222222222222222222222222220000000000222220
022222222222222222222222222222222222222222220000000000222220
022222222222222222222222222222222222222222220000000000222220
022222222222222222222222222222222222222222222222222222222220
022222222222222222222222222222222222222222222222222222222220
022222222222222222222222222222222222222222222222222222222220
022222222222222222222222222222222222222222222222222222222220
022222220000000000000000000000000000000000000002222222222220
022222222222222222222222222222222222222222222222222222222220
022222222222222222222222222222222222222222222222222222222220
022222222222222222222220022002200222222222222222222222222220
022222222222222222222202222222222022222222222222222222222220
022222222222222222222022222222222202222222222222222222222220
022222222222222222220222222222222220222222222222222222222220
022222222000000000202222222222222222020000000022222222222220
022222222222222222222222222222222222222222222222222222222220
022222222222222222222222222222222222222222222222222222222220
022222222222222222222222222222222222222222222222222222222220
022222222000000000202222222222222222020000000022222222222220
022222222222222222220222222222222220222222222222222222222220
022222222222222222222022222222222202222222222222222222222220
022222222222222222222202222222222022222222222222222222222220
022222222222222222222220022002200222222222222222222222222220
022222222222222222222222222222222222222222222222222222222220
022222222222222222222222222222222222222222222222222222222220
022222222222222222222222222222222222222222222222222222222220
022222222222222222222222222222222222222222222222222222222220
022222222222222222222222222222222222222222222222222222222220
022222222222222222222222222222222222222222222222222222222220
022222222220000022222222222222222222222222000002222222222220
022222222222222222222222222222222222222222222222222222222220
022222222222222222222222222222222222222222222222222222222220
022222222222222222222222222222222222222222222222222222222220
022222222222222222222222222222222222222222222222222222222220
022222222222222222222222222222222222222222222222222222222220
022222222222222222222220000000000002222222222222222222222220
022222222222222222222222222222222222222222222222222222222220
022222222222222222222222222222222222222222222222222222222220
022222222222222222222222222222222222222222222222222222222220
022222222222222222222222222222222222222222222222222222222220
022220000002220000022222222222222000222000000002220002222220
022220222222222222000000000000000022222222222222222222222220
022222222222222222000000000000000022222222222222222202222220
022220222222222222000000000000000022222222222222222222222220
022220022220002222022222222222222000000022222200000002222220
022222222222222222222222222222222222222222222222222222222220
022222222222222222222222222222222222222222222222222222222220
000000000000000000000000000000000000000000000000000000000000
